 	NO	images/north.png				
		WE    images/west.png
EA	  images/east.png
SO    				images/west.png
	C   220, 1, 2, 200
F				220, 220, 1, 200


11111S1111
1000000110
1111111111
      
	  