NO    images/north.png
WE    images/west.png
EA	  images/east.png
SO    images/south.png
F     225, 30, 0 
C     220, 30, 0

111111
1N 001
10 011
10 001
111111