1111111111111
1000000XBC111
1111111111111