NO    aaaa
WE    bbbb
EA	  xxxx
SO    bbbbddd
F  eeee 
C  ffff

1111111111  1111111111
10000000W1  1000000001
1011111111  1011111101
101         101    101
1011111111  101    101
1000000001  101    101
1111111101  101    101
       101  101    101
1111111101111011111101
1000000000000000000001
1111111111111111111111
