 111111111     11111111111
1S000000001   1000000000001
101111111001110111111111101
101      1000001        101
101111111001110011111111101
10000000001   1000000000001
 111111111     11111111111