NO     aaaa
WE     bbbb
EA 		
	F  eeee aaaa
C  ffff
SO    bbbbddd
1111
10N1
1111