NO     aaaa


WE



EA 		dddd
	F  eeee 1111
	C  			ffff
SO    bbbbddd
1111
10N1
1111