NO    aaaa
WE    bbbb
EA	  xxxx
SO    bbbbddd
F  eeee 
C  ffff
1111
10N1
1111