   1
  101
 10001
1000001
1110111
  101
 10001
1000001
1110111
  101
 10001
1000001
1110111
  101
  1N1
  111