NO    images/north.png
WE    images/west.png
EA	  images/east.png
SO    images/south.png
F     225, 30, 0 
C     220, 30, 0

1111
10011111111111111
10000000000000001
1100000000000100111111
1100000W00000100100011
100000011000000000000111111111111111
100000000000000000000000000000000001
101111101111101111110111111111111101111111
101   101   101    101111111     100000011
1011111011  101    1000000001    101111001
1000000001  101    101110110011  100000011
1111111101  101    101  1  11001  11111111
       101  101    101     1001  
1111111101111011111101      1001
1000000000000000000001      1001
1111111101111111111111      1001
      10001     10001       1001
       10001     1000111111111001
       10101111111000000000000001
       10000000000000111111111001
       111110011111111       1001
           1001              1001
           10001             1001
           100001111         1001
           1000000001        1001
           1111111001111111111001
                 1000000000000001
                 1111111111111111
