NO    images/north.png
WE    images/west.png
EA	  images/east.png
SO    images/south.png
F     225, 30, 0 
C     220, 30, 0

	111
1111101
1S00011
1111111