111  111
1S1  101
101  101
101  101
10111101
10000001
11111111